111111111111111111111111
1     1   1      1     1
1     1   1            1
1     1   1      1     1
1     1 11111111111 1111
11111                  1
1   1              1   1
1   1      111111  1   1
1   1  1   1    1  11 11
11 11  1   1    1  1   1
1   1  111111 111  1   1
1   1  1  1     1  1   1
1   1  1  1        1   1
1   1  11 1111111  11111
1                      1
11111                  1
1   1111 1111111111 1111
1   1       1    1     1
1                1     1
1   1       1    1     1
111111111111111111111111