111111111111111111111111
1     1     1    1     1
1     1     1          1
1     1     1    1     1
11111 111 111 1111111111
1   1              1   1
1   1                  1
1   1  111 111111  1   1
1      1        1  11111
11111  1        1  1   1
1   1  1111111111  1   1
1      1   1    1  1   1
1   1  1   1       1   1
11111  11 1111111  11 11
1                      1
1                      1
11 1111 1111111 11111111
1    1      1    1     1
1    1      1          1
1    1      1    1     1
111111111111111111111111/